level1
40
21
8
5555555555555555555555555555555555555555
5111111111112111111111111111111111111115
5116111161111111611111161111111111111115
5111111111111111111111211111111111111215
5111112111111111111111116111111111111115
5111111111111111161111161111111116111115
5111111111111111111111116111111111111115
5111111166111111111111611111111111111115
5111111121111111211111111111111111111115
5111111161111111111111161111111111111115
5111111111111111161111111111111111111115
5116111111111111111111111111111611111115
5111111111111117111111111111111111111115
5111111111111111111111161111111111111115
5111116111111111111111112111111111111115
5111111111111111111111111111111111111115
5111111111111116111111111111121111111115
5111111111111111111111111111111111611115
5111111116111111111116111111111111111115
5111111111111111111111111111111166111115
5555555555555555555555555555555555555555