level4
40
21
27
5555555555555555555555555555555555555555
5311111611111111111111111111161111111675
5111116111111111111116111111111111111115
5111111116166111111111111111111111111115
5611111111111111111111111111111111111115
5111111111111111111161111111111111111115
5161111111111111111111116111111111611115
5116111116111111111116116111111111111165
5111111611111161111111111111111111116115
5111111118311161138111111183111111381115
5111111113311161133111111133111111331115
5111111111111111111111111111111111111115
5111111111311111111111111111111111111115
5111161111311166111111111111116111611115
5111111111111111111111111111111111111115
5111111111111111111111166611111111161115
5111111161111111111111111111111111111115
5111111611111116111111111661111111111115
5111111111111111111111111111111111111115
5111111111111111161611111111111161111115
5555555555555555555555555555555555555555
