level4
40
21
27
5555555555555555555555555555555555555555
5311111611111111111114111111161111111615
5111116111111111111114116611111111111115
5111111116116111931114111111111111111115
5611111111111111331114111111133111111115
5111111331111111161164111111183111111115
5161111831111111161114116111111111611115
5116111161111111161114116111111111111115
5111111333111161111114444444444444444465
5111111333111161138114111111111111111115
5111111339111161133114111111111116111115
5111111111111111111111111111111166111115
5111111111111131111114111133111111111115
5111161111111136111114111139116183611115
5111111111111131111114111111111133111115
5111111111111111111114444444444444444445
5111111161111331111114111111111111111115
5111111611111836111114111661111111111115
5111111111111111111114111111111111111115
5111111111111111161614111111111161111175
5555555555555555555555555555555555555555