level3
40
21
18
5555555555555555555555555555555555555555
5116116111111111116111161111161111111115
5111111111116111161111111111111161111115
5111116116111111161111111111611111111115
5111111111116111111611111111611111111115
5611111111111611121111611111111116111115
5111611161161111611111166111211161111115
5111111121111611111111111611311111111115
5111111161111111111111611111111611661115
5111661111111116111111111611111111176115
5111111131161111111111311611611116111115
5111611121111111111111311111111111111115
5111111111611111111611111111611611111115
5111161111611112111111211111111111111115
5111111111111111111111661113334441611115
5111121111116111111111111113843241611115
5111611111111116111111116113334441111115
5111111611111111111111111111111161111115
5111111111116111112111161111111111161115
5111161111116111111116111111116111111115
5555555555555555555555555555555555555555