level2
40
21
12
5555555555555555555555555555555555555555
5111111111116111111111161111116111111115
5111111111111111111111111161111111111115
5111166111111111111111611111116111111115
5111111111111611111161116111111111161115
5111611111111111111111111111111611111115
5111111111111111161111116111111116111115
5111161111112111111121111111116111161115
5111111111111161111111111611111113211115
5111111112111111111116111111111116131115
5111111611111111121111161111161111211115
5111111111111111111113111111111116111115
5111111611111111611113111111111116111115
5111111111111111111111111111111166211115
5111111211161111611111611111111111111115
5111111111111111111111111111161111111115
5111161111111116111111311211111111111115
5111116111111162611161111111611116111115
5111111112111111111111111111112111111115
5111111116111111611111611111161111111115
5555555555555555555555555555555555555555
